#     ####################
#A### ####################
##### #########      #####
##### ######### #### #####
#####   ####### #### #####
####### ####### ####     B
####            ##########
###  ############ ########
### ############# ########
### ############# ########
### #############   ######
### ############# ########
###               ########
##########################
##########################