#####B#
##### #
##### #
###   #
# # # #
   A###