# ##B #####
# ###      
# ###### ##
# ##     ##
#    ######
##A########